5,2,8,1,3,total
1,0,2,2,2,7
5,0,3,1,1,10
3,2,4,0,2,11
1,2,1,1,3,8
4,0,1,1,5,11
1,0,1,0,0,2
1,0,1,0,0,2
0,0,1,1,1,3
0,0,0,1,3,4
0,0,0,0,0,0
0,0,2,1,4,7
1,0,1,0,2,4
0,0,0,0,0,0
2,0,1,0,7,10
1,0,1,0,1,3
2,0,0,0,3,5
1,0,1,0,1,3
3,0,1,1,1,6
2,0,1,0,1,4
2,0,1,0,0,3
5,0,2,0,2,9
6,0,2,1,3,12
1,0,1,1,1,4
1,0,0,1,1,3
1,0,0,1,3,5
0,0,0,0,3,3
1,0,1,0,1,3
1,0,1,0,1,3
0,1,0,2,1,4
1,0,0,0,1,2
1,0,2,1,3,7
5,1,3,2,3,14
2,1,2,0,1,6
1,0,1,0,2,4
2,0,1,1,1,5
1,0,3,0,3,7
2,0,0,0,0,2
5,0,2,0,0,7
3,0,2,0,0,5
3,1,4,1,2,11
1,0,2,0,2,5
2,0,1,0,1,4
0,0,1,0,1,2
2,0,0,0,2,4
0,0,1,0,3,4
0,0,1,0,1,2
1,0,1,0,0,2
3,1,1,0,1,6
6,0,1,1,3,11
5,1,3,2,1,12
